Processed 31 symptom tokens starting with 'b'

Back pain -> back_pain_diseases.csv (5 diseases)
back pain -> back_pain_diseases.csv (5 diseases)
balance problems -> balance_problems_diseases.csv (1 diseases)
bald patches -> bald_patches_diseases.csv (1 diseases)
blackheads -> blackheads_diseases.csv (1 diseases)
bleeding -> bleeding_diseases.csv (11 diseases)
bleeding while brushing -> bleeding_while_brushing_diseases.csv (1 diseases)
blindness -> blindness_diseases.csv (1 diseases)
Blisters -> blisters_diseases.csv (3 diseases)
Blisters on lips or around the mouth -> blisters_on_lips_or_around_the_mouth_diseases.csv (1 diseases)
Bloating -> bloating_diseases.csv (12 diseases)
bloating -> bloating_diseases.csv (12 diseases)
blood in sputum -> blood_in_sputum_diseases.csv (1 diseases)
blood in stool -> blood_in_stool_diseases.csv (3 diseases)
Blood in urine -> blood_in_urine_diseases.csv (6 diseases)
blood in urine -> blood_in_urine_diseases.csv (6 diseases)
Blurred vision -> blurred_vision_diseases.csv (4 diseases)
blurred vision -> blurred_vision_diseases.csv (4 diseases)
body ache -> body_ache_diseases.csv (6 diseases)
body aches -> body_aches_diseases.csv (5 diseases)
bone deformities -> bone_deformities_diseases.csv (1 diseases)
Bone fractures -> bone_fractures_diseases.csv (1 diseases)
Bone pain -> bone_pain_diseases.csv (4 diseases)
bone pain -> bone_pain_diseases.csv (4 diseases)
breathing -> breathing_diseases.csv (15 diseases)
breathing problems -> breathing_problems_diseases.csv (2 diseases)
Breathlessness -> breathlessness_diseases.csv (1 diseases)
brittle hair -> brittle_hair_diseases.csv (1 diseases)
bulging eyes -> bulging_eyes_diseases.csv (1 diseases)
bull's-eye rash -> bull_s_eye_rash_diseases.csv (1 diseases)
burning sensation -> burning_sensation_diseases.csv (1 diseases)
